..........
..........
G#........
.#####....
.#S.#.....
##..#.....
#...#.....
#...#.....
##..#####.
##........