..........
..........
G#........
.########.
.#......#.
##......#.
#.......#.
S.......#.
##.....##.
##........